##########
#b X    X#
#        #
#  C     #
#        #
#      # #
# C    #C#
#      # #
# X    #E#
##########